tiles_spritesheet.png
4 70 70
1 504 576 70 70
2 576 864 70 70
3 576 648 70 70
4 576 504 70 70

000000S00000000
000000000000000
000000000000000
000000000000000
100000000000001
100003140000001
100000000000001
100000000000001
111111111111111
222222222222222